1 0 1
5 5
0 1 2 1 0
1 2 3 2 1
2 3 4 3 2
1 2 3 2 1
0 1 2 1 0
3
1 1
3 2
0.5 3.5
