1 -1 1
10 10
0 0 0 0 0 0 0 0 0 0
0 1 1 1 1 1 1 1 1 0
0 1 1 1 1 1 1 1 1 0
0 1 1 2 2 2 2 1 1 0
0 1 1 2 3 3 2 1 1 0
0 1 1 2 3 3 2 1 1 0
0 1 1 2 2 2 2 1 1 0
0 1 1 1 1 1 1 1 1 0
0 1 1 1 1 1 1 1 1 0
0 0 0 0 0 0 0 0 0 0
2
1.5 1.5
4.5 4.5
1
4 0.5
0 0
0 3
3 3
3 6
