1 -1 1
20 20
0 0 0 0 0 0 0 0 0 0 0 0 0 0 0 0 0 0 0 0
0 1 1 1 1 1 1 1 1 0 0 1 1 1 1 1 1 1 1 0
0 1 1 1 1 1 1 1 1 0 0 1 1 1 1 1 1 1 1 0
0 1 1 2 2 2 2 1 1 0 0 1 1 2 2 2 2 1 1 0 
0 1 1 2 3 3 2 1 1 0 0 1 1 2 3 3 2 1 1 0 
0 1 1 2 3 3 2 1 1 0 0 1 1 2 3 3 2 1 1 0
0 1 1 2 2 2 2 1 1 0 0 1 1 2 2 2 2 1 1 0 
0 1 1 1 1 1 1 1 1 0 0 1 1 1 1 1 1 1 1 0
0 1 1 1 1 1 1 1 1 0 0 1 1 1 1 1 1 1 1 0
0 0 0 0 0 0 0 0 0 0 0 0 0 0 0 0 0 0 0 0
0 0 0 0 0 0 0 0 0 0 0 0 0 0 0 0 0 0 0 0
0 1 1 1 1 1 1 1 1 0 0 1 1 1 1 1 1 1 1 0
0 1 1 1 1 1 1 1 1 0 0 1 1 1 1 1 1 1 1 0
0 1 1 2 2 2 2 1 1 0 0 1 1 2 2 2 2 1 1 0 
0 1 1 2 3 3 2 1 1 0 0 1 1 2 3 3 2 1 1 0 
0 1 1 2 3 3 2 1 1 0 0 1 1 2 3 3 2 1 1 0
0 1 1 2 2 2 2 1 1 0 0 1 1 2 2 2 2 1 1 0 
0 1 1 1 1 1 1 1 1 0 0 1 1 1 1 1 1 1 1 0
0 1 1 1 1 1 1 1 1 0 0 1 1 1 1 1 1 1 1 0
0 0 0 0 0 0 0 0 0 0 0 0 0 0 0 0 0 0 0 0
8
1.5 1.5
4.5 4.5
11.5 1.5
14.5 4.5
1.5 11.5
4.5 14.5
11.5 11.5
14.5 14.5
0
